11111111
100C00E1
1C00C001
1P000C01
11111111
