11111111
111101E1
1C10C101
1P000C01
11111111
