11111111
11C100E1
1C10C001
1P000C01
11111111
