11111111
111101E1
1C10C101
1P000001
11111111
