NO textures/wallN.xpm
SO textures/wallS.xpm
WE textures/bricks.xpm
EA textures/wood.xpm

C 153,255,250
F 100,100,100

       111111111111111111111111
       1000000000110000000000001
       1011000001110000000000001
       1001000000000000000000001
111111111011000001110000000000001
100000000011000001110111110011111
11110111111111011100000010001
11110111111111001 101010010001
11000000110101011100000010001
10000000000000001100000010001
10000000000000001101010010001
11000001110101011111011110N0111
11110111 1110101 101111010001
1111111111111111 111111111111

