1111111111111111111111111111111
1C0000000000000000000000C0000E1
1000000000000000000000000000001
1000000000000000000000000000001
1000000000000000000000000000001
100C000000000000000000000000001
100000000000000000000000C000001
1000000000000000000000000000001
10P0000000000000000000000000001
1111111111111111111111111111111
