1111111111111111111111111111111
1C0000B00000000000000B00C0000E1
1000000000000000000000000000001
10000000000000B0000000000000001
10000000000000000000000000000B1
100C000000000000000000000000001
100000000000000000000000C000001
1000000000000000000000000000001
10P000000000000000B000000000001
1111111111111111111111111111111

