1111111111111111111111
10C00000000000000000E1
100000000C000000000001
100000000000000C000001
1000000000000000000001
1P00000000000000000001
1111111111111111111111
