1111111111111111111111
10C0000B000000000000E1
100000000C000000000001
100000000000000C000001
100000B000000000000B01
1P00000000000000000001
1111111111111111111111
